KPIs

Benötigte Kennzahlen
EPS - Earnings per share
PER - Price earnings ratio				
PEG - Price earnings to growth ratio
DPR - Dividend price ratio
CFS - Cashflow per share
PCF - Price cash flow ratio
PBV - Price to book value
PSR - Price sales ratio
EQR	- Equity ratio
DTR	- Debt ratio
ROE	- Return on equity
POR - Payout ratio
GRM - Gross margin
OPM - Operating margin
BVS	- Book value per share

Alpha 	-
Beta 	-
Sharpe	-

Benötigte Daten:
Täglich:
Price						Kurs
Buy Price					Briefkurs
Sell Price					Geldkurs
Market capitalisation		Marktkap. (Intraday)

Monatlich:
Revenue						Umsatz (ttm)
Operating income			GuV -> Operativer Gewinn
Net Income					GuV -> Jahresüberschuss
Dividend					Tatsächlicher Dividendenertrag (absolut, nicht in Prozent)
Outstanding Shares			Auf Yahoo nicht vorhanden, kann aber über die Marktkapitalisierung und Kurs berechnet werden
Operating Cashflow			Cash Flow aus laufender Geschäftstätigkeit
Free Cashflow				Levered Free Cash Flow
Working Capital				Nicht vorhanden
Book Value					Indirekt über Equity / # Shares
Equity						Indirekt über Schulden (gesamt) und Schulden/Equity (gesamt)
Debt						Schulden (gesamt)
Balance Sheet Total			Bilanz -> Anlagevermögen oder indirekt über Buchwert je Aktie
EBITDA						EBITDA

